quit	辞去
employment	工作
occur	被想到
block	阻碍
prompt	促使
minister	部长
cover	掩盖
claim	声称
compel	迫使
eager	渴望的	+ to do sth渴望做某事
absolute	绝对的
reality	现实
transform	使改变（性质、作用、形态）
advocate	拥护者，提倡
philosohpy	（人生）哲学
preach	宣传
enable	使能够
status	地位		the status quo现状
doctrine	教义,信条
characterize	以...为特征
experiment	实践,尝试
alternative	可供选择的
deadline	最后期限
strain	压力
politics	手腕
emerge	浮现
limitation	限制
extreme	极大的
simplicity	简朴
simplify	简化
voluntary	自愿的
breed	产生		bred（过去式）
tip	提示
equivalent	相等
recovery	复苏
thrift	节俭
acquaintance	熟人    stranger
organic	有机的
recognition	识别
decline	衰退

词组：
lateral move	平级调度
a high	profile	惹人注目
settle for...	满足于...
well-established	公认的
cling-film	保鲜膜
drop out	退学

超纲词：
relatively	相对地
disgraced	丢脸的
downshift	降档,放慢生活的节奏
passionate	热情的
meterialistic	贪图享乐的
redundancy	裁员
adventurous	有冒险精神的
mythical	神话般的