barrel	一桶
triple	使变成三倍
memory	记忆
shock	冲击
inflation	通货膨胀		deflation	通货紧缩
headline	大字标题
doom	厄运
suspend	暂停
strengthen	加强
grip	抓紧
consequence	影响
hemisphere	半球
reduction	减少
export	出口
global	全球的
severe	严重的
petrol	汽油
retail	零售		retailer	零售商
mute	减弱，使...变得温和
commodity	商品
tax	税
consumption	消费
impact	影响
significant	重要的
squeeze	紧缩，压榨
income	收入		salary，allowance，wage，revenue
loss	损失
conservation	节约
sensitive	敏感的
swing	摇摆
fuel	燃料
crude	原油，未加工的
estimate	估计
excess	过量的
demand	需求
portion	一部分
index	指数
gloomy	沮丧的
conclusion	结论
unlike	不像

词组：
crude oil	原油
oil	shock	石油危机
gloom and doom	厄运
push up	使持续增长，提高
account for	占...比例/是...原因
pump price	出泵价格
energy-intensive industry	能源密集型工业

超纲词：
gloom 忧郁
quadruple	变为四倍
irrelevant	无关的
scared	害怕的
