base	把...设在
simply	仅仅		not simply	but also
decade	十年
corporation	公司
firm	公司
company	公司
former	以前的	the former	前者
reinforce	加强
professor	教授
mail	邮件
analysis	分析
status	地位
available	可获得的
predict	预测
episode	事件，一段情节
revolution	革命
intelligence	情报
unique	独特的
honor	授予...
guarantee	确保
exert	施加
influential	有影响力的
crisis	危机
military	军事
spying	从事间谍活动
whereby	借此
pastime	休闲活动
vocation	职业		vacation	假期
profession	职业
click	点击
web     网
lean	精简的
efficient	有效的
official	官方的
staff	员工
contest	竞赛
restore	恢复
revive	恢复
dramatic	戏剧的
reliable	可信赖的

词组：
lay the roots for...	为...打下基础
rely on...	依靠...
make the biggest splash	取得最大的成功
see...as...	视...为...
tell...from...	把...和...区别开
by a large margin	以很大的优势领先

超纲词：
fascinated	入迷的
reshape	重塑
remold	改造
popularity	流行
prediction	预言
truthfulness	真实性
emergence	出现
nonconformist	不随大流的